3
8 3
0 0 0 0 0 1 0 0
0 1 0 1 0 0 0 1
0 0 0 0 0 0 0 0
0 0 0 1 0 1 0 0
0 0 1 1 0 0 0 0
0 0 0 0 0 0 0 0
0 0 0 0 1 0 1 0
1 0 0 0 0 0 0 0
7 7
0 0 0 1 0 0 0
0 0 0 0 0 0 0
0 0 0 0 0 0 0
1 0 0 0 0 0 1
0 0 0 0 0 0 0
0 0 0 0 0 0 0
0 0 0 1 0 0 0
10 5
0 0 0 0 0 0 0 0 0 0
0 0 1 0 0 0 0 0 1 1
0 0 0 0 0 1 0 0 1 0
0 0 0 0 0 1 1 0 0 0
0 1 0 0 0 0 0 0 0 1
1 0 0 1 1 1 0 0 0 0
0 1 0 1 0 1 0 0 0 1
0 0 0 0 0 0 1 0 0 1
0 0 1 1 0 0 0 0 0 0
0 0 0 1 0 0 1 1 0 0