2
5 6 2 1 3
0 0 5 3 6 0
0 0 2 0 2 0
3 3 1 3 7 0
0 0 0 0 0 0
0 0 0 0 0 0
5 6 2 2 6
3 0 0 0 0 3
2 0 0 0 0 6
1 3 1 1 3 1
2 0 2 0 0 2
0 0 4 3 1 1
10 10 4 3 9